victim	culprit(s)	description	notes
Akihiro Altland		Slain by Iok Kujan's subordinates	
Allium Gyojan	Mikazuki Augus	Shot by Mikazuki Augus	
Amida Arca		Shot down by the Arianrhod Fleet	
Aston Altland	McGillis Fareed	Fatally wounded by McGillis Fareed	
Biscuit Griffon	Carta Issue	Fatally injured when his vehicle is cut in half by Carta Issue	
Builth	Builth	Hanged himself with his bandages	
Carta Issue	Mikazuki Augus	Fatally wounded by Mikazuki Augus	
Coral Conrad	Mikazuki Augus	Impaled by Mikazuki Augus using his mace's needle	
Crank Zent	Mikazuki Augus	Shot by Mikazuki Augus	
Danji Enrei	Orlis Stenja	Crushed inside his vehicle by Orlis Stenja	
Ein Dalton	Mikazuki Augus	Impaled by Mikazuki Augus using his katana	
Elgar		Slain by the Arianrhod Fleet	
Fumitan Admoss		Shot by a sniper hired by Nobliss Gordon	
Galan Mossa	Galan Mossa	Activated his Mobile Suit's self destruct	
Haeda Gunnel	Mikazuki Augus	Shot by Mikazuki Augus	
Hush Middy		Cut in half by a soldier of the Arianrhod Fleet	
Iok Kujan	Akihiro Altland	Crushed by Akihiro Altland	
Isurugi Camice	Gaelio Bauduin	Impaled by Gaelio Bauduin using his drill knee	
Jasley Donomikols	Mikazuki Augus	Crushed by Mikazuki Augus	
Kudal Cadel	Mikazuki Augus	Cleaved in half by Mikazuki Augus' katana	
Lafter Frankland		Shot by Jasley Donomikols' men	
Liza Enza		Shot down by the Arianrhod Fleet	
Masahiro Altland	Kudal Cadel	Crushed against space debris by Kudal Cadel	
McGillis Fareed	Gaelio Bauduin	Shot in the chest by Gaelio Bauduin	
Mikazuki Augus		Fatally wounded by an orbital strike sent by the Arianrhod Fleet	
Navona Mingo		Shot by Gjallarhorn forces	
Naze Turbine		Fatal ship collision after being shot down by Iok Kujan's fleet	
Nobliss Gordon	Ride Mass	Shot multiple times by Ride Mass	
Norba Shino		Mobile Suit shot down by the Arianrhod Fleet	
Orga Itsuka		Shot multiple times by hitmen hired by Nobliss Gordon	
Orlis Stenja	Mikazuki Augus	Crushed by Mikazuki Augus using his mace	
Pedro	Mikazuki Augus	Slain by Mikazuki Augus	
Radiche Riloto	Takaki Uno	Shot by Takaki Uno	
Sasai Yankus	Mikazuki Augus	Shot by Mikazuki Augus	
Savarin Canele	Savarin Canele	Hanged himself	
Togonosuke Makanai		Passed away from natural causes	
Vito	Mikazuki Augus	Slain by Mikazuki Augus	